
F 184,113,39
C 51,198,227

NO textures/wall_1.xpm
SO textures/wall_2.xpm
WE textures/wall_3.xpm
EA textures/wall_4.xpm


   11111111111111111
111000111   11110001
10000011111 11111001
10000N00001 10000001
11111111111 11111111
