NO textures/stone/stone_1.xpm
SO textures/stone/stone_2.xpm
WE textures/stone/stone_3.xpm
EA textures/stone/stone_4.xpm
SO1 textures/stone/stone_2.xpm
WE1 textures/stone/stone_3.xpm
OB textures/stone/fontaine1.xpm
OBP textures/stone/fontaine2.xpm
FP textures/stone/stone_floor.xpm
CP textures/sky/sky.xpm

F 150,150,150
C 199,207,225
1111111111111111
100C000000000001
1000000000000001
1000000000000001
1000000100000001
10000000N0000001
1000000000000001
1111111111111111
